##########           #      #       #              ###                     #      ########  #
#        #           #      #       #              | #                     #             #   
#        #           #      #       #              | #                     |         # # #  #
#        #           #      #       #              | #                     # ## #  ### # #  #
#        #           #      #       #              # #                     #    #      # #  #
#        #           #      #       #              # #     /               ### ##  ##### #  #
#        #           |      #       #              # #    /                #    #   #    #  #
#        #           #      #       #              # #___/                 # ###### #    #  #
#        #           #      #       #   /          # ####        \         #      # #    #  #
#        #           #      ____    #  /           # #  |         \________#_#  ##  #    #  #
#        #      /    #      #_/     __/            # #  |        ##||      # #  #  ####  #  #
#_        _____/     #      #       #              # #  |          |/      ###  #        #  #
#|########    |      #      #       #              # #  |          /|      #    # ####   #  #
#_#           |      |      |       |          ##### #  |          ||      ##  ##    # ###  #
#|#           |      |      |       |          |   # #  |          ||      #   #  ## # #    #
#_#           |      #      #       |          #_  # #  /          ||      #   #   #   # #  #
#|#           |      #_     #_      |          # _ # # /|          ||      ### ### ##    #  #
#|            |      #      #       |          #  _# _/ |          ||      #   #    #  # #  #
#################################################_########################## ### ####  # # ##
#################################################                            ##  #    ## # ##
#################################################                            #  #  ##### # ##
###########################################################################_##  #  ##    # ##
###########################################################################_          #### ##
########################################################################################## ##
########################################################################################## ##
########################################################################################## ##
########################################################################################## ##
########################################################################################## ##
########################################################################################## ##
########################################################################################## ##
########################################################################################## ##
########################################################################################## ##
########################################################################################## ##
########################################################################################## ##
########################################################################################## ##
#                                                                                           #
#                                                                                           #
#                                                                                           #
#                                                                                           #
#                                                                                           #
#                                                                                           #
#                                                                                           #
#                                            /\                                             #
#                                           /\/\                                            #
#                                          /\/\/\                                           #
#                                         /\/\/\/\                                          #
#                                        /\/\/\/\/\                                         #
#                                       /\/\/\/\/\/\                                        #
#                                      /\/\/\/\/\/\/\                                       #
#                                     /\/\/\/\/\/\/\/\                                      #
#                                    /\/\/\/\/\/\/\/\/\                                     #
#                                   /\/\/\/\/\/\/\/\/\/\                                    #
#                                  /\/\/\/\/\/\/\/\/\/\/\                                   #
#                                 /\/\/\/\/\/\/\/\/\/\/\/\                                  #
#                                /\/\/\/\/\/\/\/\/\/\/\/\/\                                 #
#                               /\/\/\/\/\/\/\/\/\/\/\/\/\/\                                #
#                              /\/\/\/\/\/\/\/\/\/\/\/\/\/\/\                               #
#                             /\/\/\/\/\/\/\/\/\/\/\/\/\/\/\/\                              #
#                            /\/\/\/\/\/\/\/\/\/\/\/\/\/\/\/\/\                             #
#                           /\/\/\/\/\/\/\/\/\/\/\/\/\/\/\/\/\/\                            #
#                          /\/\/\/\/\/\/\/\/\/\/\/\/\/\/\/\/\/\/\                           #
#                         /\/\/\/\/\/\/\/\/\/\/\/\/\/\/\/\/\/\/\/\                          #
#                        /\/\/\/\/\/\/\/\/\/\/\/\/\/\/\/\/\/\/\/\/\                         #
#                       /\/\/\/\/\/\/\/\/\/\/\/\/\/\/\/\/\/\/\/\/\/\                        #
#                      /\/\/\/\/\/\/\/\/\/\/\/\/\/\/\/\/\/\/\/\/\/\/\                       #
#                     /\/\/\/\/\/\/\/\/\/\/\/\/\/\/\/\/\/\/\/\/\/\/\/\                      #
#                    /\/\/\/\/\/\/\/\/\/\/\/\/\/\/\/\/\/\/\/\/\/\/\/\/\                     #
#                   /\/\/\/\/\/\/\/\/\/\/\/\/\/\/\/\/\/\/\/\/\/\/\/\/\/\                    #
#                  /\/\/\/\/\/\/\/\/\/\/\/\/\/\/\/\/\/\/\/\/\/\/\/\/\/\/\                   #
#                 /\/\/\/\/\/\/\/\/\/\/\/\/\/\/\/\/\/\/\/\/\/\/\/\/\/\/\/\                  #
#                /\/\/\/\/\/\/\/\/\/\/\/\/\/\/\/\/\/\/\/\/\/\/\/\/\/\/\/\/\                 #
#               /\/\/\/\/\/\/\/\/\/\/\/\/\/\/\/\/\/\/\/\/\/\/\/\/\/\/\/\/\/\                #
#              /\/\/\/\/\/\/\/\/\/\/\/\/\/\/\/\/\/\/\/\/\/\/\/\/\/\/\/\/\/\/\               #
#             /\/\/\/\/\/\/\/\/\/\/\/\/\/\/\/\/\/\/\/\/\/\/\/\/\/\/\/\/\/\/\/\              #
#            /\/\/\/\/\/\/\/\/\/\/\/\/\/\/\/\/\/\/\/\/\/\/\/\/\/\/\/\/\/\/\/\/\             #
#           /\/\/\/\/\/\/\/\/\/\/\/\/\/\/\/\/\/\/\/\/\/\/\/\/\/\/\/\/\/\/\/\/\/\            #
#          /\/\/\/\/\/\/\/\/\/\/\/\/\/\/\/\/\/\/\/\/\/\/\/\/\/\/\/\/\/\/\/\/\/\/\           #
#         /\/\/\/\/\/\/\/\/\/\/\/\/\/\/\/\/\/\/\/\/\/\/\/\/\/\/\/\/\/\/\/\/\/\/\/\          #
#        /\/\/\/\/\/\/\/\/\/\/\/\/\/\/\/\/\/\/\/\/\/\/\/\/\/\/\/\/\/\/\/\/\/\/\/\/\         #
#       /\/\/\/\/\/\/\/\/\/\/\/\/\/\/\/\/\/\/\/\/\/\/\/\/\/\/\/\/\/\/\/\/\/\/\/\/\/\        #
#      /\/\/\/\/\/\/\/\/\/\/\/\/\/\/\/\/\/\/\/\/\/\/\/\/\/\/\/\/\/\/\/\/\/\/\/\/\/\/\       #
#     /\/\/\/\/\/\/\/\/\/\/\/\/\/\/\/\/\/\/\/\/\/\/\/\/\/\/\/\/\/\/\/\/\/\/\/\/\/\/\/\      #
#    /\/\/\/\/\/\/\/\/\/\/\/\/\/\/\/\/\/\/\/\/\/\/\/\/\/\/\/\/\/\/\/\/\/\/\/\/\/\/\/\/\     #
#   /\/\/\/\/\/\/\/\/\/\/\/\/\/\/\/\/\/\/\/\/\/\/\/\/\/\/\/\/\/\/\/\/\/\/\/\/\/\/\/\/\/\    #
#  /\/\/\/\/\/\/\/\/\/\/\/\/\/\/\/\/\/\/\/\/\/\/\/\/\/\/\/\/\/\/\/\/\/\/\/\/\/\/\/\/\/\/\   #
# /\/\/\/\/\/\/\/\/\/\/\/\/\/\/\/\/\/\/\/\/\/\/\/\/\/\/\/\/\/\/\/\/\/\/\/\/\/\/\/\/\/\/\/\  #
#/\/\/\/\/\/\/\/\/\/\/\/\/\/\/\/\/\/\/\/\/\/\/\/\/\/\/\/\/\/\/\/\/\/\/\/\/\/\/\/\/\/\/\/\/\ #
#############################################################################################