                          
                          
 Y      Y        Y      Y 
 --  Y  |    ____|  Y  -- 
 --  |  __Y_/ Y  |  |  -  
 --  |  |________|  |  -  
 -- _Y__/        \__Y__Y_ 
 ------------------------ 
