--------------------------
-_    __                 -
- ------  - ------------ -
-______-  - -      --    -
- ---- -  -   - --_  _-_ -
-_-_    _   - - --------_-
-  _---- ---  -     -_   -
-_-    - -  _----- _- -- -
-_ _--_ _ _-_     _  _  _-
--------------------------
--------------------------